判断をする	を	推論判断を
処理を用いる	を	記号処理を
注目を集める	  が を	ある その後 サポートベクターマシンが 注目を
学習を行う	を に を	経験を 元に 学習を
流行を超える	を	流行を
学習を繰り返す	を	学習を
進化を見せる	て  は て において を	活躍している 特に 敵対的生成ネットワークは 加えて 生成技術において 進化を
生成を行う	を	コンテンツ生成を
開発を行う	 は を	製作した エイダ・ラブレスは 開発を
テストをする	を	テストを
処理を行う	 を	適用し 処理を
処理を行う	に により に を	同年に ティム・バーナーズリーにより Webに 知的処理を
意味をする	に を	データに 意味を
処理を行う	て に を	付加して コンピュータに 知的処理を
研究を進める	て を	費やして 研究を
運転をする	 に を	増やし 元に 運転を
特許をする	までに が を	2018年までに 日本が 特許を
研究をする	を	研究を
運転をする	て に を	基づいて 柔軟に 運転を
注目を集める	 から は  を	世界初であった ことから ファジィは 関わらず 注目を
制御をする	を	ニューロファジィ制御を
成功を受ける	を	成功を
制御を用いる	て も を	受けて 他社も 知的制御を
制御をする	を	知的制御を
進歩を担う	を	進歩を
改善を果たす	に で が を	2012年に 画像処理コンテストで チームが 精度改善を
プログラムを使う	を	専用プログラムを
研究を続ける	が て を	ジェフホーキンスが 向けて 研究を
)をする	 には を	開発 8月には 記号接地問題(シンボルグラウンディング問題)を
注目を集める	に を	急速に 注目を
普及を受ける	を	普及を
学習を組み合わせる	を	機械学習を
投資を行う	に で を	全世界的に 民間企業主導で 投資を
探索を行う	 で を	実装し 無報酬で 探索を
研究を始める	は とも を	Googleは マックスプランク研究所とも 共同研究を
研究を行う	 て を	いう 始めており 研究を
開発をする	では  で を	中国では 立ち上げ 官民一体で 研究開発を
実験をする	を	実験を
開発をする	で を	日本で 研究開発を
投資をする	は までに を	韓国は 2022年までに 投資を
学習をする	を	深層学習を
シミュレーションを行う	を	脳シミュレーションを
反乱を起こす	て に対して を	於いて 人間に対して 反乱を
弾圧を併せ持つ	を	弾圧を
手続きを経る	を を	ウイグル族を 法的手続きを
差別を認める	を	差別を
研究をする	を	研究を
展開を変える	を	展開を
戦争をする	を	戦争を
制御をする	は を	AIプログラムは ファジィ制御を
判断を介す	から を	観点から 判断を
禁止を求める	 には が を	記された 4月には ヒューマン・ライツ・ウォッチが 禁止を
運用をめぐる	を	運用を
記録をする	を	記録を
試験を行う	を	試験を
追及を受ける	 て では とともに と で を	なった 暴露されており 公聴会では とともに 拒否すると 整合性で 追及を
研究をする	が を	Microsoftが 共同研究を
解任をする	  て は を	発表した しかし 含まれており Google社員らは 解任を
解散をする	  は が で を	要請した 4月4日 Googleは 倫理委員会が 理由で 解散を
存在を見いだす	に を	ものに 霊的存在を
)」をする	を	道)」を
実現をする	を	実現を
話をする	は  を	哲学者は みんな 話を
疎通を行う	を	意思疎通を
勘違いをする	を	勘違いを
議論を行う	まで   を	これまで けっこう 長時間 議論を
